20 20
p p p p p p p p p p p p p p p p p p o p
p p o p p p p p p p p p p p p o p p p p
p p p p p p p p p p o p p p p p p p p p
p p p p p p p p p p p p p p p p p p p p
p p p p p p o p p p p p p p p p p p p p
p p p p p p p p p p p p p p p p o p p p
p p p o p p p p p p p p p p p p p p p p
o p p p p p p p p p p o p p p p p p p p
p p p p p p p p p p p p p p p p p p p p
p p p p p p p o p p p p p p o p p p o p
p p p p p p p p p p p p p p p p p p p p
p p p p p p p p p p p p p p p p p p p p
o p p p p p p p p p p p p p p p p p p p
p p p p p p p p p p p p p p p o p p p p
p p p p o p p p p p p p p p p p p p p p

